﻿#date
OpenButton=Ouvrir
LaunchButton=Lancer
AbortButton=Arrêter
BackButton=Retourner
ProcessTitle1=Découper en sol et bâtiment (1/6)
ProcessTitle2=Découper les bâtiments entre eux (2/6)
ProcessTitle3=Séparer les murs et les toits de chaque bâtiment (3/6)
ProcessTitle4=Séparer les murs et les toits entre eux pour chaque bâtiment (4/6)
ProcessTitle5=Déterminer les voisins de chaque mur ou toit (5/6)
ProcessTitle6=Trier les voisins de chaque mur ou toit (6/6)
ProcessTitle7=Déterminer le contour de chaque mur ou toit
ProcessTitle8=Recoller les sols
ProcessTitle9=Simplifier les sols
IsletProcess=Ilot : étape 
CType=Type
CDelete=Supprimer
CMerge=Fusionner
CPutInNoise=Mettre dans le bruit
CSortOutNeighbours=Trier les voisins
UseGravityNormal=Utiliser la normale orientée selon la gravité
RotationCenter=Modifier le centre de rotation
DisplayMeshes=Afficher les surfaces
DisplayPolygons=Afficher les pôlygones
LockMesh=Verouiller le maillage
UnlockMesh=Déverouiller le maillage
SelectTriangles=Passer en mode de sélection : triangles
SelectMeshes=Passer en mode de sélection : surfaces
SelectTrianglesLabel=Mode de sélection : triangles
SelectMeshesLabel=Mode de sélection : surfaces
DisplayMeshesLabel=Affichage : Surfaces
DisplayPolygonsLabel=Affichage : Pôlygones
TreeView=Arborescence
Parameters=Paramètres
StatusStep1=Vous pouvez modifier les paramètres à l'aide de l'onglet "paramètres".
Title=Nantes 1900
AltitureError=Erreur d'altitude
AngleGroundError=Erreur d'angle au sol
LargeAngleGroundError=Erreur d'angle large au sol
BlockGroundsSizeError=Erreur de taille du sol
BlockBuildingSize=Erreur de taille des bâtiments
NormalToError=Erreur à la normale
LargeAngleError=Erreur d'angle large
MiddleAngleError=Erreur d'angle moyen
PlanesError=Erreur plane
RoofAngleError=Erreur d'angle au toît
RoofSizeError=Erreur de taille du toît
WallAngleError=Erreur d'angle au mur
WallSizeError=Erreur de taille du mur
IsOrientedFactor=Facteur d'orientation
Characteristics=Caractéristiques
ToValid=Valider
HideItem=Cacher l'élément sélectionné
FileParamExtension=txt
FileParamDescription=Fichier texte